20
10
XXXXXXXXXXXXXXXXXXXX
XXXXOO0XXXOOOOOXXXXX
XXXPOOOXXOOOOOOOXXXX
XXOOObOOXXXObOOOTXXX
XTOOOOOOXXXXOOOOXXXX
XOXOWOHXXXXXOBOOXXXX
XOXXOOXXXXOOOOOOOOXX
XOXXOXXXXXXOOOOXOOEX
XOXOOOOOXXXOOOOXOOXX
XBOOOOOOTXXXOOBOOXXX