20
10
XXXXXXXXXXXXXXXXXXXX
XXXOOXXXTOOO1OOXXXXX
XPOOO1XXXOOOOOOOXXXX
XOOOOXXXXXOHOOWOOOXX
XXEXXXXBXXOOOOOOOOBX
XXXXXXOOOOOXOOOOOOXX
XXXXXXOXXXXXOOOOHOOX
XXXTOHOXXXXOOOOOOOXX
XXWOOHOOOOOOOOOWOOOX
XBOOOHOXXXTXXXOOBXXX