21
10
XXXXXXXXXXXXXXXXXXXXX
XXXXOO0XXXOOOOOOXXXXX
XXXPOOOXXOOOOOOOOXXXX
XXOOObOOXXXObOOOOTXXX
XTOOOOOOXXXXOOOOOXXXX
XOXOOOHXXXXXOBOOOXXXX
XOXXOOXXXXOOOOOOOWOXX
XOXXOXXXXXXOOOOXOOOEX
XOXOOOOOXXXOOOOXOOOXX
XBOOOOOOTXXXOOBOOOXXX