20
10
XXXXXXXXXXXXXXXXXXXX
XXPXXXXX2XXXX1OOXXXX
X1OEXXOOOOOXXXOOOXXX
XXXXXOOXXXOOXXXOOOWT
XXXXOOXXBXXOOXXXXX2X
XXBOOXXHHHXXOOOXXXXX
XOOXXXWOOOOXXXOOOXXX
XOXXXWOOOOOOXXXXOOXX
XOOXXXHHHHHHHXXXXO3X
XXOTXXXTOOOOO3XXBOXX