20
10
XXXXXXXXXXXXXXXXXXXX
XXXOOOXXX1OOOO2XXXXX
XBOOOOOXXXXOOOOOOWXX
XOXOOOOOXXXXOOOOOOBX
XOXXOOXOOXXXOTXXXXXX
XPOOOWXOOOXXXXXXXXXX
XOXXOOXEXOOXXXXBOXXX
XOXOOOOXXXOOXXXOOWXX
XOOOOOOOXXOOXXTOOOOX
XXX1OOOOOOOOBXXOOO2X