21
10
XXXXXXXXXXXXXXXXXXXXX
XXXXOO0XXXOOOOOXXXXXX
XXXPOOOXXOOOOOOOOXXXX
XXOOO1OOXXXO1OOOOTXXX
XTOOOOOOXXXXOOOOOXXXX
XOXOOOHXXXXXOBOOOXXXX
XOXXOOXXXXOOOOOOOWOXX
XOXXOXXXXXXOOOOXOOOEX
XOXOOOOOXXXOOOOXOOOXX
XBOOOOOOTXXXOOBOOOXXX