20
10
XXXXXXXXXXXXXXXXXXXX
XXOPOXOOXXXXXObXXXXX
XXXOOOOXXXXOOOOOXXXX
XXXXXOOOOOOWOOOOOBXX
XXXXTOOOOOOOOXXXXXXX
XXXXXOBXXXXOXXXXXXBX
XXTXXXXXXXXXXXOOOOOX
XXOOXXXOOOXXXOOXOOXX
XXOOOOOOOOOOWOOXOXXX
XXXOObXXXOOOOOOOOOEX