20
10
XXXXXXXXXXXXXXXXXXXX
XXXOOOXXXbOOOOOXXXXX
XOOOOOBXXXXOOOOOOWXX
XOXOOOOOXXXXOOOOOOTX
XOXXOOXOOXXXOBXXXXXX
XPOOOWXOOOXXXXXXXXXX
XOXXOOXEXOOXXXXTOXXX
XOXOOOOXXXOOXXXOOOXX
XOOOOOOOXXOOXXOOOOWX
XXXBOOOOOOOObXXOOOBX