20
10
XXXXXXXXXXXXXXXXXXXX
XXO0dOXOOXXXXXO1XXXXX
XXXOPOOXXXXOOOOOXXXX
XXXXXOOOOOOWOHOOOBXX
XXXXTOOOOOOOOXXXXXXX
XXXXXOBXXXXOXXXXXXBX
XXTXXXXXXXXXXXOOOOOX
XXOOXXXOOOXXXOOXOOXX
XXOOOOOOOOOOWOOXHXXX
XXXOO1XXXOOOOOOOOOEX