20
10
XXXXXXXXXXXXXXXXXXXX
XXXOOOXXX1OOOO2XXXXX
XBOOOHOXXXXOOHOOOOXX
XOXOOOOOXXXXOOWOOOBX
XOXXOOXOOXXXOTXXXXXX
XPOOOWXOOOXXXXXXXXXX
XOXXOOXEXOOXXXXBOXXX
XOXOOOOXXXOOXXXOOWXX
XOOOOHOOXXOOXXTOOOOX
XXX1OOOOOOOOBXXOOO2X