20
10
XXXXXXXXXXXXXXXXXXXX
XXO0dOXOOXXXXXO1XXXXX
XXXOPOOXXXXOOOOOXXXX
XXXXXOOOOOOWOOOOOBXX
XXXXTOOOOOOOOXXXXXXX
XXXXXOBXXXXOXXXXXXBX
XXTXXXXXXXXXXXOOOOOX
XXOOXXXOOOXXXOOXOOXX
XXOOOOOOOOOOWOOXOXXX
XXXOO1XXXOOOOOOOOOEX