20
10
XXXXXXXXXXXXXXXXXXXX
XXXXOOBXXXOOOOOXXXXX
XXXPOOOXXOOOOOOOXXXX
XXOOObOOXXXObOOOOXXX
XOOOOOOOOXXXOOOOXXXX
XOXOOOHXXXXXOBOOXXXX
XOXXOOXXXXOOOOOOOOXX
XOXXWXXXXXXOOOOXOOEX
XOXOOOOOXXXOOOOXOOXX
XBOOOOOOOTXXOOBOOXXX