20
10
XXXXXXXXXXXXXXXXXXXX
XXXOOOXXX1OOOO2XXXXX
XBOOOOOXXXXOOOOOOOXX
XOXOOOOOXXXXOOWOOOBX
XOXXOOXOOXXXOTXXXXXX
XPOOOWXOOOXXXXXXXXXX
XOXXOOXEXOOXXXXBOXXX
XOXOOOOXXXOOXXXOOWXX
XOOOOOOOXXOOXXTOOOOX
XXX1OOOOOOOOBXXOOO2X